"a" = (/turf/simulated/floor/plating/snow,/area/dungeon)
"b" = (/obj/structure/flora/grass/green,/turf/simulated/floor/plating/snow,/area/dungeon)
"c" = (/obj/structure/flora/grass/both,/turf/simulated/floor/plating/snow,/area/dungeon)
"d" = (/obj/structure/flora/tree/dead,/turf/simulated/floor/plating/snow,/area/dungeon)
"e" = (/turf/simulated/floor/plating/snow,/turf/simulated/floor/plating/snow{tag = "icon-gravsnow_corner (SOUTHEAST)"; icon_state = "gravsnow_corner"; dir = 6},/turf/simulated/floor/plating/snow{tag = "icon-snow_corner (EAST)"; icon_state = "snow_corner"; dir = 4},/turf/simulated/floor/plating/snow{tag = "icon-snow_corner"; icon_state = "snow_corner"},/turf/simulated/floor/plating/snow{tag = "icon-snow_corner (EAST)"; icon_state = "snow_corner"; dir = 4},/turf/simulated/floor/plating/snow{tag = "icon-snow_corner (NORTH)"; icon_state = "snow_corner"; dir = 1},/obj/structure/flora/grass/brown,/turf/simulated/floor/plating/snow{tag = "icon-snow_corner (WEST)"; icon_state = "snow_corner"; dir = 8},/area/dungeon)
"f" = (/turf/simulated/floor/plating/snow,/turf/simulated/floor/plating/snow{tag = "icon-gravsnow_corner (SOUTHWEST)"; icon_state = "gravsnow_corner"; dir = 10},/turf/simulated/floor/plating/snow{tag = "icon-snow_corner (EAST)"; icon_state = "snow_corner"; dir = 4},/turf/simulated/floor/plating/snow{tag = "icon-snow_corner"; icon_state = "snow_corner"},/turf/simulated/floor/plating/snow{tag = "icon-snow_corner (EAST)"; icon_state = "snow_corner"; dir = 4},/turf/simulated/floor/plating/snow{tag = "icon-snow_corner (NORTH)"; icon_state = "snow_corner"; dir = 1},/turf/simulated/floor/plating/snow{tag = "icon-snow_corner (WEST)"; icon_state = "snow_corner"; dir = 8},/area/dungeon)
"g" = (/turf/simulated/floor/plating/snow,/turf/simulated/floor/plating/snow{tag = "icon-snow_corner (WEST)"; icon_state = "snow_corner"; dir = 8},/area/dungeon)
"h" = (/obj/structure/flora/grass/brown,/turf/simulated/floor/plating/snow,/area/dungeon)
"i" = (/obj/structure/flora/tree/dead,/obj/structure/flora/rock/pile{step_x = 4; step_y = -4},/turf/simulated/floor/plating/snow,/area/dungeon)
"j" = (/turf/simulated/floor/plating/snow,/turf/simulated/floor/plating/snow{tag = "icon-gravsnow_corner (NORTHEAST)"; icon_state = "gravsnow_corner"; dir = 5},/turf/simulated/floor/plating/snow{tag = "icon-snow_corner (NORTH)"; icon_state = "snow_corner"; dir = 1},/turf/simulated/floor/plating/snow{tag = "icon-snow_corner"; icon_state = "snow_corner"},/turf/simulated/floor/plating/snow{tag = "icon-snow_corner (EAST)"; icon_state = "snow_corner"; dir = 4},/turf/simulated/floor/plating/snow{tag = "icon-snow_corner (NORTH)"; icon_state = "snow_corner"; dir = 1},/turf/simulated/floor/plating/snow{tag = "icon-snow_corner (WEST)"; icon_state = "snow_corner"; dir = 8},/area/dungeon)
"k" = (/turf/simulated/floor/plating/snow,/turf/simulated/floor/plating/snow{tag = "icon-gravsnow_corner (NORTHWEST)"; icon_state = "gravsnow_corner"; dir = 9},/turf/simulated/floor/plating/snow{tag = "icon-snow_corner (EAST)"; icon_state = "snow_corner"; dir = 4},/turf/simulated/floor/plating/snow{tag = "icon-snow_corner"; icon_state = "snow_corner"},/turf/simulated/floor/plating/snow{tag = "icon-snow_corner (EAST)"; icon_state = "snow_corner"; dir = 4},/turf/simulated/floor/plating/snow{tag = "icon-snow_corner (NORTH)"; icon_state = "snow_corner"; dir = 1},/turf/simulated/floor/plating/snow{tag = "icon-snow_corner (WEST)"; icon_state = "snow_corner"; dir = 8},/area/dungeon)
"l" = (/obj/structure/flora/tree/pine,/turf/simulated/floor/plating/snow,/area/dungeon)
"m" = (/turf/simulated/floor/plating/snow{tag = "icon-gravsnow"; icon_state = "gravsnow"},/turf/simulated/floor/plating/snow{tag = "icon-snow_surround (WEST)"; icon_state = "snow_surround"; dir = 8},/area/dungeon)
"n" = (/turf/simulated/floor/plating/snow{tag = "icon-gravsnow"; icon_state = "gravsnow"},/turf/simulated/floor/plating/snow{tag = "icon-snow_surround (EAST)"; icon_state = "snow_surround"; dir = 4},/area/dungeon)
"o" = (/obj/structure/flora/bush,/turf/simulated/floor/plating/snow,/area/dungeon)
"p" = (/turf/simulated/floor/plating/snow,/turf/simulated/floor/plating/snow{tag = "icon-gravsnow_surround (EAST)"; icon_state = "gravsnow_surround"; dir = 4},/turf/simulated/floor/plating/snow{tag = "icon-snow_surround (WEST)"; icon_state = "snow_surround"; dir = 8},/turf/simulated/floor/plating/snow{tag = "icon-snow_surround (EAST)"; icon_state = "snow_surround"; dir = 4},/area/dungeon)
"q" = (/obj/structure/flora/rock{step_x = -7; step_y = 16},/obj/structure/flora/rock/pile{step_x = 12; step_y = -12},/obj/structure/closet/abductor{name = "Lost Pod"; step_x = 1; step_y = 10},/obj/item/weapon/gun/projectile/automatic/pistol/secpistol,/obj/item/ammo_box/c9mmNL,/obj/item/weapon/storage/box{step_x = -3; step_y = 1},/obj/item/weapon/storage/box{step_x = 7; step_y = 1},/obj/item/weapon/restraints/handcuffs/cable,/turf/simulated/floor/engine/cult{tag = "icon-silver_dam"; icon_state = "silver_dam"},/area/dungeon)
"r" = (/turf/simulated/floor/plating/snow,/turf/simulated/floor/plating/snow{tag = "icon-gravsnow_corner (NORTHEAST)"; icon_state = "gravsnow_corner"; dir = 5},/turf/simulated/floor/plating/snow{tag = "icon-snow_corner (NORTH)"; icon_state = "snow_corner"; dir = 1},/area/dungeon)
"s" = (/turf/simulated/floor/plating/snow{tag = "icon-gravsnow"; icon_state = "gravsnow"},/turf/simulated/floor/plating/snow{tag = "icon-snow_corner (EAST)"; icon_state = "snow_corner"; dir = 4},/turf/simulated/floor/plating/snow{tag = "icon-snow_corner (NORTH)"; icon_state = "snow_corner"; dir = 1},/area/dungeon)
"t" = (/turf/simulated/floor/plating/snow,/obj/structure/flora/tree/pine,/turf/simulated/floor/plating/snow{tag = "icon-gravsnow_corner (EAST)"; icon_state = "gravsnow_corner"; dir = 4},/area/dungeon)
"u" = (/turf/simulated/floor/plating/snow,/turf/simulated/floor/plating/snow{tag = "icon-gravsnow_surround"; icon_state = "gravsnow_surround"},/area/dungeon)
"v" = (/turf/simulated/floor/plating/snow,/turf/simulated/floor/plating/snow{tag = "icon-gravsnow_corner (WEST)"; icon_state = "gravsnow_corner"; dir = 8},/area/dungeon)
"w" = (/turf/simulated/floor/plating/snow,/turf/simulated/floor/plating/snow{tag = "icon-gravsnow_corner (NORTH)"; icon_state = "gravsnow_corner"; dir = 1},/area/dungeon)

(1,1,1) = {"
aabaaaac
defghaia
ajklaaaa
acmnoaha
alpqaala
ahrsatuv
dacwahwc
aaalbada
"}
