"aa" = (/turf/simulated/floor/plating/snow,/area/dungeon)
"ab" = (/obj/structure/flora/grass/both,/turf/simulated/floor/plating/snow,/area/dungeon)
"ac" = (/turf/simulated/wall,/area/dungeon)
"ad" = (/turf/simulated/wall/rust,/area/dungeon)
"ae" = (/obj/structure/flora/rock/pile,/turf/simulated/floor/plating/snow,/area/dungeon)
"af" = (/obj/structure/flora/grass/brown,/turf/simulated/floor/plating/snow,/area/dungeon)
"ag" = (/turf/simulated/wall/r_wall/rust,/area/dungeon)
"ah" = (/obj/machinery/vending/hydronutrients,/turf/simulated/floor/plasteel/floorgrime,/area/dungeon)
"ai" = (/obj/machinery/seed_extractor,/turf/simulated/floor/plasteel/floorgrime,/area/dungeon)
"aj" = (/obj/machinery/biogenerator,/obj/effect/spacevine,/obj/effect/spacevine{tag = "icon-Hvy1"; icon_state = "Hvy1"},/turf/simulated/floor/vines,/area/dungeon)
"ak" = (/obj/machinery/vending/hydroseeds,/obj/effect/spacevine,/obj/effect/spacevine{tag = "icon-Hvy1"; icon_state = "Hvy1"},/turf/simulated/floor/vines,/area/dungeon)
"al" = (/turf/simulated/wall/r_wall,/area/dungeon)
"am" = (/obj/structure/flora/tree/dead,/turf/simulated/floor/plating/snow,/area/dungeon)
"an" = (/obj/structure/flora/rock,/turf/simulated/floor/plating/snow,/area/dungeon)
"ao" = (/obj/structure/flora/grass/green,/turf/simulated/floor/plating/snow,/area/dungeon)
"ap" = (/obj/machinery/light{dir = 1},/obj/effect/spacevine,/obj/effect/spacevine{tag = "icon-Hvy1"; icon_state = "Hvy1"},/turf/simulated/floor/vines,/area/dungeon)
"aq" = (/turf/simulated/floor/plasteel/sepia,/area/dungeon)
"ar" = (/turf/simulated/floor/grass,/area/dungeon)
"as" = (/obj/effect/spacevine,/obj/effect/spacevine,/obj/effect/spacevine{tag = "icon-Hvy1"; icon_state = "Hvy1"},/turf/simulated/floor/vines,/area/dungeon)
"at" = (/mob/living/simple_animal/hostile/tree,/turf/simulated/floor/plating/snow,/area/dungeon)
"au" = (/obj/effect/spacevine,/obj/effect/spacevine{tag = "icon-Hvy1"; icon_state = "Hvy1"},/turf/simulated/floor/vines,/area/dungeon)
"av" = (/obj/effect/spacevine,/obj/effect/spacevine{tag = "icon-Hvy1"; icon_state = "Hvy1"},/obj/effect/spacevine{tag = "icon-Hvy1"; icon_state = "Hvy1"},/obj/effect/spacevine{tag = "icon-Hvy1"; icon_state = "Hvy1"},/turf/simulated/floor/vines,/area/dungeon)
"aw" = (/obj/machinery/hydroponics,/turf/simulated/floor/grass,/area/dungeon)
"ax" = (/turf/simulated/floor/plasteel/neutral,/area/dungeon)
"ay" = (/turf/simulated/floor/sepia,/area/dungeon)
"az" = (/turf/simulated/floor/plasteel/floorgrime,/area/dungeon)
"aA" = (/turf/simulated/floor/plasteel,/area/dungeon)
"aB" = (/mob/living/simple_animal/hostile/creature,/turf/simulated/floor/grass,/area/dungeon)
"aC" = (/obj/machinery/hydroponics,/turf/simulated/floor/grass{color = "brown"},/area/dungeon)
"aD" = (/obj/machinery/light_construct,/turf/simulated/floor/sepia,/area/dungeon)
"aE" = (/turf/simulated/floor/plating/snow,/obj/structure/flora/tree/dead,/turf/simulated/floor/plating/snow{tag = "icon-gravsnow_corner"; icon_state = "gravsnow_corner"},/area/dungeon)
"aF" = (/turf/simulated/wall/rust,/turf/simulated/floor/plating/snow{tag = "icon-snow_corner"; icon_state = "snow_corner"},/area/dungeon)
"aG" = (/turf/simulated/floor/plating/snow,/mob/living/simple_animal/hostile/tree,/turf/simulated/floor/plating/snow{tag = "icon-gravsnow_corner (SOUTHEAST)"; icon_state = "gravsnow_corner"; dir = 6},/area/dungeon)
"aH" = (/obj/structure/flora/grass/brown,/turf/simulated/floor/plating/snow/gravsnow,/area/dungeon)
"aI" = (/turf/simulated/floor/plating/snow,/turf/simulated/floor/plating/snow{tag = "icon-gravsnow_corner (SOUTHWEST)"; icon_state = "gravsnow_corner"; dir = 10},/area/dungeon)
"aJ" = (/turf/simulated/floor/plating/snow,/turf/simulated/floor/plating/snow{tag = "icon-gravsnow_corner"; icon_state = "gravsnow_corner"},/area/dungeon)
"aK" = (/obj/machinery/light_construct,/obj/effect/spacevine,/obj/effect/spacevine{tag = "icon-Hvy1"; icon_state = "Hvy1"},/turf/simulated/floor/vines,/area/dungeon)
"aL" = (/obj/machinery/light,/obj/effect/spacevine,/obj/effect/spacevine{tag = "icon-Hvy1"; icon_state = "Hvy1"},/turf/simulated/floor/vines,/area/dungeon)
"aM" = (/turf/simulated/wall,/turf/simulated/floor/plating/snow{tag = "icon-snow_corner (SOUTHEAST)"; icon_state = "snow_corner"; dir = 6},/area/dungeon)
"aN" = (/turf/simulated/floor/plasteel/sepia,/turf/simulated/floor/plating/snow{tag = "icon-gravsnow_surround (NORTH)"; icon_state = "gravsnow_surround"; dir = 1},/turf/simulated/floor/plating/snow{tag = "icon-snow_surround (NORTH)"; icon_state = "snow_surround"; dir = 1},/area/dungeon)
"aO" = (/turf/simulated/wall,/turf/simulated/floor/plating/snow{tag = "icon-snow_corner (WEST)"; icon_state = "snow_corner"; dir = 8},/area/dungeon)
"aP" = (/turf/simulated/floor/plasteel/stairs/left,/area/dungeon)
"aQ" = (/turf/simulated/floor/plasteel/stairs/medium,/area/dungeon)
"aR" = (/obj/structure/flora/grass/green,/turf/simulated/floor/plating/snow/gravsnow,/area/dungeon)
"aS" = (/turf/simulated/floor/plating/snow/gravsnow,/area/dungeon)
"aT" = (/obj/structure/table,/obj/item/weapon/storage/toolbox/syndicate,/turf/simulated/floor/sepia,/area/dungeon)
"aU" = (/obj/structure/table,/obj/effect/spacevine,/obj/effect/spacevine{tag = "icon-Hvy1"; icon_state = "Hvy1"},/turf/simulated/floor/vines,/area/dungeon)
"aV" = (/turf/simulated/wall/r_wall/rust,/turf/simulated/floor/plating/snow{tag = "icon-snow_corner (EAST)"; icon_state = "snow_corner"; dir = 4},/area/dungeon)
"aW" = (/turf/simulated/floor/plasteel/sepia,/turf/simulated/floor/plating/snow{tag = "icon-snow_surround (WEST)"; icon_state = "snow_surround"; dir = 8},/area/dungeon)
"aX" = (/turf/simulated/floor/plasteel/sepia,/obj/item/weapon/twohanded/fireaxe/sawcleaver,/turf/simulated/floor/plating/snow{tag = "icon-snow_corner (SOUTHEAST)"; icon_state = "snow_corner"; dir = 6},/area/dungeon)
"aY" = (/turf/simulated/wall,/turf/simulated/floor/plating/snow{tag = "icon-gravsnow_corner (EAST)"; icon_state = "gravsnow_corner"; dir = 4},/area/dungeon)
"aZ" = (/obj/structure/flora/grass/both,/turf/simulated/floor/plating/snow/gravsnow,/area/dungeon)
"ba" = (/mob/living/simple_animal/hostile/tree,/turf/simulated/floor/plating/snow/gravsnow,/area/dungeon)
"bb" = (/turf/simulated/wall/r_wall/rust,/turf/simulated/floor/plating/snow{tag = "icon-snow_corner (NORTH)"; icon_state = "snow_corner"; dir = 1},/area/dungeon)
"bc" = (/turf/simulated/wall/rust,/turf/simulated/floor/plating/snow{tag = "icon-snow_corner (NORTH)"; icon_state = "snow_corner"; dir = 1},/area/dungeon)
"bd" = (/obj/machinery/door/airlock/highsecurity,/turf/simulated/floor/plasteel/sepia,/area/dungeon)
"be" = (/turf/simulated/wall,/turf/simulated/floor/plating/snow{tag = "icon-gravsnow_corner (NORTH)"; icon_state = "gravsnow_corner"; dir = 1},/area/dungeon)
"bf" = (/turf/simulated/wall/r_wall,/turf/simulated/floor/plating/snow{tag = "icon-gravsnow_corner (NORTH)"; icon_state = "gravsnow_corner"; dir = 1},/turf/simulated/floor/plating/snow{tag = "icon-gravsnow_corner (EAST)"; icon_state = "gravsnow_corner"; dir = 4},/area/dungeon)
"bg" = (/turf/simulated/wall/r_wall,/turf/simulated/floor/plating/snow{tag = "icon-snow_corner (WEST)"; icon_state = "snow_corner"; dir = 8},/area/dungeon)
"bh" = (/obj/machinery/vending/engivend,/turf/simulated/floor/sepia,/area/dungeon)
"bi" = (/obj/machinery/vending/tool,/turf/simulated/floor/plasteel/floorgrime,/area/dungeon)
"bj" = (/obj/machinery/suit_storage_unit/standard_unit,/turf/simulated/floor/sepia,/area/dungeon)
"bk" = (/obj/machinery/vending/assist,/turf/simulated/floor/sepia,/area/dungeon)
"bl" = (/obj/machinery/vending/sustenance,/turf/simulated/floor/sepia,/area/dungeon)
"bm" = (/mob/living/simple_animal/hostile/faithless,/turf/simulated/floor/plasteel/sepia,/area/dungeon)
"bn" = (/obj/machinery/light_construct{dir = 1},/turf/simulated/floor/plasteel/sepia,/area/dungeon)
"bo" = (/turf/simulated/floor/plasteel/asteroid,/area/dungeon)
"bp" = (/obj/machinery/light{dir = 1},/turf/simulated/floor/plasteel/sepia,/area/dungeon)
"bq" = (/turf/simulated/wall/rust,/turf/simulated/floor/plating/snow{tag = "icon-gravsnow_corner (EAST)"; icon_state = "gravsnow_corner"; dir = 4},/area/dungeon)
"br" = (/turf/simulated/floor/plating/snow,/turf/simulated/floor/plating/snow{tag = "icon-gravsnow_corner (NORTHWEST)"; icon_state = "gravsnow_corner"; dir = 9},/area/dungeon)
"bs" = (/obj/structure/bookcase/random,/turf/simulated/floor/plasteel/cult,/area/dungeon)
"bt" = (/turf/simulated/floor/plasteel/cult,/area/dungeon)
"bu" = (/turf/simulated/floor/plating/snow,/turf/simulated/floor/plating/snow{tag = "icon-gravsnow_corner (WEST)"; icon_state = "gravsnow_corner"; dir = 8},/area/dungeon)
"bv" = (/obj/structure/table,/turf/simulated/floor/plasteel,/area/dungeon)
"bw" = (/obj/structure/table,/turf/simulated/floor/sepia,/area/dungeon)
"bx" = (/obj/structure/table,/obj/item/weapon/storage/toolbox/electrical{step_x = 3; step_y = 7},/turf/simulated/floor/plasteel/floorgrime,/area/dungeon)
"by" = (/turf/simulated/wall,/turf/simulated/floor/plating/snow{tag = "icon-snow_corner (EAST)"; icon_state = "snow_corner"; dir = 4},/area/dungeon)
"bz" = (/turf/simulated/floor/plating/snow,/turf/simulated/floor/plating/snow{tag = "icon-gravsnow_corner (NORTH)"; icon_state = "gravsnow_corner"; dir = 1},/area/dungeon)
"bA" = (/turf/simulated/floor/plating/snow,/obj/structure/flora/grass/brown,/turf/simulated/floor/plating/snow{tag = "icon-gravsnow_corner"; icon_state = "gravsnow_corner"},/area/dungeon)
"bB" = (/obj/structure/table,/turf/simulated/floor/plasteel/floorgrime,/area/dungeon)
"bC" = (/turf/simulated/floor/sepia,/turf/simulated/floor/plating/snow{tag = "icon-gravsnow_corner"; icon_state = "gravsnow_corner"},/area/dungeon)
"bD" = (/turf/simulated/floor/sepia,/turf/simulated/floor/plating/snow{tag = "icon-gravsnow_corner (SOUTHEAST)"; icon_state = "gravsnow_corner"; dir = 6},/area/dungeon)
"bE" = (/obj/structure/bookcase/random,/turf/simulated/floor/engine/cult,/area/dungeon)
"bF" = (/obj/structure/cultgirder,/obj/structure/divine/healingfountain{step_x = 1; step_y = 15},/turf/simulated/floor/plasteel/cult,/area/dungeon)
"bG" = (/turf/simulated/floor/plating/snow,/turf/simulated/floor/plating/snow{tag = "icon-gravsnow_corner (EAST)"; icon_state = "gravsnow_corner"; dir = 4},/area/dungeon)
"bH" = (/turf/simulated/wall/rust,/turf/simulated/floor/plating/snow{tag = "icon-snow_corner (WEST)"; icon_state = "snow_corner"; dir = 8},/area/dungeon)
"bI" = (/turf/simulated/floor/sepia,/obj/machinery/light_construct,/turf/simulated/floor/plating/snow{tag = "icon-gravsnow_corner (SOUTHEAST)"; icon_state = "gravsnow_corner"; dir = 6},/area/dungeon)
"bJ" = (/turf/simulated/floor/plasteel/floorgrime,/turf/simulated/floor/plating/snow{tag = "icon-gravsnow_corner (SOUTHWEST)"; icon_state = "gravsnow_corner"; dir = 10},/area/dungeon)
"bK" = (/turf/simulated/floor/plasteel/floorgrime,/turf/simulated/floor/plating/snow{tag = "icon-gravsnow_corner (SOUTHEAST)"; icon_state = "gravsnow_corner"; dir = 6},/area/dungeon)
"bL" = (/obj/structure/flora/rock/pile,/turf/simulated/floor/plating/snow/gravsnow,/area/dungeon)
"bM" = (/turf/simulated/floor/plasteel,/turf/simulated/floor/plating/snow{tag = "icon-gravsnow_corner (WEST)"; icon_state = "gravsnow_corner"; dir = 8},/obj/machinery/door/airlock/glass,/turf/simulated/floor/plating/snow{tag = "icon-gravsnow_surround (WEST)"; icon_state = "gravsnow_surround"; dir = 8},/area/dungeon)
"bN" = (/obj/structure/cultgirder,/turf/simulated/floor/plasteel/cult,/area/dungeon)
"bO" = (/obj/structure/cult/talisman,/turf/simulated/floor/plasteel/cult,/area/dungeon)
"bP" = (/turf/simulated/floor/plating/snow,/obj/structure/flora/grass/both,/turf/simulated/floor/plating/snow{tag = "icon-gravsnow_corner (SOUTHWEST)"; icon_state = "gravsnow_corner"; dir = 10},/area/dungeon)
"bQ" = (/turf/simulated/floor/plating/snow,/mob/living/simple_animal/hostile/tree,/turf/simulated/floor/plating/snow{tag = "icon-gravsnow_corner (EAST)"; icon_state = "gravsnow_corner"; dir = 4},/area/dungeon)
"bR" = (/turf/simulated/wall/r_wall/rust,/turf/simulated/floor/plating/snow{tag = "icon-gravsnow_corner (SOUTHWEST)"; icon_state = "gravsnow_corner"; dir = 10},/area/dungeon)
"bS" = (/turf/simulated/wall,/turf/simulated/floor/plating/snow{tag = "icon-gravsnow_corner"; icon_state = "gravsnow_corner"},/area/dungeon)
"bT" = (/turf/simulated/wall/r_wall/rust,/turf/simulated/floor/plating/snow{tag = "icon-gravsnow_corner (WEST)"; icon_state = "gravsnow_corner"; dir = 8},/turf/simulated/floor/plating/snow{tag = "icon-gravsnow_corner"; icon_state = "gravsnow_corner"},/area/dungeon)
"bU" = (/turf/simulated/floor/plasteel/stage_bottom,/area/dungeon)
"bV" = (/obj/machinery/light,/obj/machinery/light_construct,/mob/living/simple_animal/hostile/faithless,/turf/simulated/floor/plasteel/cult,/area/dungeon)
"bW" = (/turf/simulated/floor/plating/snow,/obj/structure/flora/rock/pile,/turf/simulated/floor/plating/snow{tag = "icon-gravsnow_corner (WEST)"; icon_state = "gravsnow_corner"; dir = 8},/area/dungeon)
"bX" = (/obj/structure/flora/tree/dead,/turf/simulated/floor/plating/snow/gravsnow,/area/dungeon)
"bY" = (/turf/simulated/floor/plating/snow{tag = "icon-gravsnow"; icon_state = "gravsnow"},/area/dungeon)
"bZ" = (/turf/simulated/wall/r_wall,/turf/simulated/floor/plating/snow{tag = "icon-snow_corner (WEST)"; icon_state = "snow_corner"; dir = 8},/turf/simulated/floor/plating/snow{tag = "icon-snow_corner"; icon_state = "snow_corner"},/area/dungeon)
"ca" = (/turf/simulated/floor/plasteel/stairs/old,/area/dungeon)
"cb" = (/turf/simulated/wall/r_wall/rust,/turf/simulated/floor/plating/snow{tag = "icon-gravsnow_corner"; icon_state = "gravsnow_corner"},/turf/simulated/floor/plating/snow{tag = "icon-gravsnow_corner (EAST)"; icon_state = "gravsnow_corner"; dir = 4},/area/dungeon)
"cc" = (/turf/simulated/floor/plating/snow/gravsnow,/turf/simulated/floor/plating/snow{tag = "icon-snow_corner (EAST)"; icon_state = "snow_corner"; dir = 4},/area/dungeon)
"cd" = (/turf/simulated/floor/plating/snow,/turf/simulated/floor/plating/snow{tag = "icon-gravsnow_corner (NORTHEAST)"; icon_state = "gravsnow_corner"; dir = 5},/area/dungeon)
"ce" = (/turf/simulated/floor/plating/snow/gravsnow,/turf/simulated/floor/plating/snow{tag = "icon-gravsnow_corner (NORTH)"; icon_state = "gravsnow_corner"; dir = 1},/area/dungeon)
"cf" = (/turf/simulated/floor/plating/snow,/obj/structure/flora/grass/both,/turf/simulated/floor/plating/snow{tag = "icon-gravsnow_corner"; icon_state = "gravsnow_corner"},/area/dungeon)
"cg" = (/obj/machinery/light,/turf/simulated/floor/plasteel/floorgrime,/area/dungeon)
"ch" = (/obj/machinery/light_construct,/turf/simulated/floor/plasteel/sepia,/area/dungeon)
"ci" = (/turf/simulated/floor/plating/snow/gravsnow,/obj/structure/flora/grass/both,/turf/simulated/floor/plating/snow{tag = "icon-gravsnow_corner (EAST)"; icon_state = "gravsnow_corner"; dir = 4},/area/dungeon)
"cj" = (/turf/simulated/floor/plating/snow/gravsnow,/turf/simulated/floor/plating/snow{tag = "icon-gravsnow_corner (EAST)"; icon_state = "gravsnow_corner"; dir = 4},/area/dungeon)
"ck" = (/turf/simulated/floor/plating/snow,/turf/simulated/floor/plating/snow{tag = "icon-gravsnow_corner (SOUTHWEST)"; icon_state = "gravsnow_corner"; dir = 10},/obj/structure/flora/grass/green,/turf/simulated/floor/plating/snow{tag = "icon-gravsnow_corner (SOUTHEAST)"; icon_state = "gravsnow_corner"; dir = 6},/area/dungeon)
"cl" = (/obj/machinery/door/airlock/hatch,/turf/simulated/floor/plasteel,/area/dungeon)
"cm" = (/turf/simulated/wall/rust,/turf/simulated/floor/plating/snow{tag = "icon-gravsnow_corner"; icon_state = "gravsnow_corner"},/area/dungeon)
"cn" = (/turf/simulated/wall/r_wall,/turf/simulated/floor/plating/snow{tag = "icon-gravsnow_corner"; icon_state = "gravsnow_corner"},/turf/simulated/floor/plating/snow{tag = "icon-gravsnow_corner (EAST)"; icon_state = "gravsnow_corner"; dir = 4},/area/dungeon)
"co" = (/turf/simulated/floor/plating/snow,/obj/structure/flora/grass/both,/turf/simulated/floor/plating/snow{tag = "icon-gravsnow_corner (NORTHEAST)"; icon_state = "gravsnow_corner"; dir = 5},/area/dungeon)
"cp" = (/turf/simulated/floor/plating/snow,/obj/structure/flora/rock/pile,/turf/simulated/floor/plating/snow{tag = "icon-gravsnow_corner (NORTHWEST)"; icon_state = "gravsnow_corner"; dir = 9},/area/dungeon)

(1,1,1) = {"
aaabacacadadadacaaabaaaaaaaaaeaaaaabaaaa
afagacahaiajakacalaeamaaanaaafaaamaaaaao
adadapaqararasapadacafatabataaataaaaabaa
adauavawauarawaqaxacacacadadacaaabataaae
acayawarauarauawaqayazaAazauauacaaaaaaaa
acauawauaraBauaCazaqauaDayazauadaaaEatab
acauauawararawauayacaFadayazayadaGaHaIaJ
acadaKazarauasaLacaMaNaOaPaQauadaRaSaSaS
amagacaTaUaUaUacaVaWaXaOaKaqaDaYaSaZbaaS
afabacaOacadadacacbbbcacacbdadacbebfaSaZ
aaaaatbgbhbibjbkbladbmbnazboaqbpaqbqaSbr
aaaaaaaOayazayazayacazbsbsbtbsbsboaYbabu
atatafaObvbwbxazaAacbobtbtbtbtbtazbybzbA
aaanaaaObBbCayaybDacaAbsbEbFbsbsaqbybGaS
ataaaabHbIaSbJbKbLbMazbNbtbObtbNaAacbPbz
aoabbQbRbSaZaSaSbTadaqbUbtbVbtbUboaYaSbW
aaaabGaSaSaSbXbYbrbZadcaacacadcaaccbccaa
amataacdaSbrbzcecfaaaOcgaqboazchaYciaSbu
abaaaaatbzaaaabQcjckbTbSbSclcmaFcnaSbrab
aaataaaaabataabGaHaSbrcoaSaScpafbzbzataa
"}
