"aa" = (/turf/simulated/floor/plating/snow,/area/dungeon)
"ab" = (/obj/structure/flora/rock,/turf/simulated/floor/plating/snow,/area/dungeon)
"ac" = (/turf/simulated/floor/plating/snow,/turf/simulated/floor/plating/snow{tag = "icon-gravsnow_corner"; icon_state = "gravsnow_corner"},/area/dungeon)
"ad" = (/obj/structure/flora/grass/both,/turf/simulated/floor/plating/snow,/area/dungeon)
"ae" = (/obj/structure/flora/tree/dead,/turf/simulated/floor/plating/snow,/area/dungeon)
"af" = (/obj/structure/window,/turf/simulated/floor/plating/snow,/area/dungeon)
"ag" = (/obj/structure/flora/grass/green,/turf/simulated/floor/plating/snow,/area/dungeon)
"ah" = (/turf/simulated/floor/plating/snow,/turf/simulated/floor/plating/snow{tag = "icon-gravsnow_corner (EAST)"; icon_state = "gravsnow_corner"; dir = 4},/area/dungeon)
"ai" = (/turf/simulated/floor/plating/snow,/mob/living/simple_animal/hostile/tree,/turf/simulated/floor/plating/snow{tag = "icon-gravsnow_corner (EAST)"; icon_state = "gravsnow_corner"; dir = 4},/area/dungeon)
"aj" = (/turf/simulated/floor/plating/snow/gravsnow,/area/dungeon)
"ak" = (/turf/simulated/floor/plating/snow/gravsnow,/mob/living/simple_animal/hostile/tree,/turf/simulated/floor/plating/snow{tag = "icon-snow_corner (EAST)"; icon_state = "snow_corner"; dir = 4},/area/dungeon)
"al" = (/turf/simulated/wall/mineral/wood,/area/dungeon)
"am" = (/obj/structure/window{tag = "icon-window (SOUTHEAST)"; icon_state = "window"; dir = 6},/turf/simulated/floor/plasteel/cult,/area/dungeon)
"an" = (/mob/living/simple_animal/hostile/tree,/turf/simulated/floor/plating/snow,/area/dungeon)
"ao" = (/turf/simulated/floor/plating/snow,/turf/simulated/wall/mineral/wood{tag = "icon-4-e"; icon_state = "4-e"},/area/dungeon)
"ap" = (/turf/simulated/floor/plating/snow,/turf/simulated/wall/mineral/wood{tag = "icon-4-i"; icon_state = "4-i"},/turf/simulated/wall/mineral/wood{tag = "icon-3-w"; icon_state = "3-w"},/turf/simulated/wall/mineral/wood{tag = "icon-2-n"; icon_state = "2-n"},/area/dungeon)
"aq" = (/obj/structure/table/holo/poker,/turf/simulated/floor/wood,/area/dungeon)
"ar" = (/turf/simulated/floor/plating/snow,/turf/simulated/wall/mineral/wood{tag = "icon-3-i"; icon_state = "3-i"},/turf/simulated/wall/mineral/wood{tag = "icon-4-e"; icon_state = "4-e"},/turf/simulated/wall/mineral/wood{tag = "icon-1-n"; icon_state = "1-n"},/area/dungeon)
"as" = (/turf/simulated/floor/plating/snow,/obj/structure/flora/rock/pile,/turf/simulated/floor/plating/snow{tag = "icon-snow_corner (NORTHEAST)"; icon_state = "snow_corner"; dir = 5},/area/dungeon)
"at" = (/turf/simulated/floor/plating/snow/gravsnow,/obj/structure/flora/tree/dead,/turf/simulated/floor/plating/snow{tag = "icon-snow_corner (EAST)"; icon_state = "snow_corner"; dir = 4},/area/dungeon)
"au" = (/turf/simulated/floor/plating/snow,/obj/structure/flora/rock,/turf/simulated/floor/plating/snow{tag = "icon-gravsnow_corner (EAST)"; icon_state = "gravsnow_corner"; dir = 4},/area/dungeon)
"av" = (/turf/simulated/floor/plating/snow/gravsnow,/turf/simulated/floor/plating/snow{tag = "icon-snow_corner (EAST)"; icon_state = "snow_corner"; dir = 4},/area/dungeon)
"aw" = (/obj/structure/table/holo/wood,/turf/simulated/floor/wood{tag = "icon-wood-broken7"; icon_state = "wood-broken7"},/area/dungeon)
"ax" = (/obj/structure/table/holo/wood,/turf/simulated/floor/wood,/area/dungeon)
"ay" = (/obj/structure/table/holo/wood,/obj/machinery/light{dir = 1},/turf/simulated/floor/wood,/area/dungeon)
"az" = (/obj/structure/piano,/turf/simulated/floor/wood,/area/dungeon)
"aA" = (/obj/structure/bed/chair/wood/normal{tag = "icon-wooden_chair (WEST)"; icon_state = "wooden_chair"; dir = 8},/turf/simulated/floor/wood,/area/dungeon)
"aB" = (/turf/simulated/floor/wood,/area/dungeon)
"aC" = (/turf/simulated/floor/wood{tag = "icon-wood-broken2"; icon_state = "wood-broken2"},/area/dungeon)
"aD" = (/obj/structure/window{tag = "icon-window (WEST)"; icon_state = "window"; dir = 8},/turf/simulated/floor/plating/snow,/area/dungeon)
"aE" = (/turf/simulated/floor/plating/snow,/mob/living/simple_animal/hostile/tree,/turf/simulated/floor/plating/snow{tag = "icon-gravsnow_corner (SOUTHWEST)"; icon_state = "gravsnow_corner"; dir = 10},/area/dungeon)
"aF" = (/mob/living/simple_animal/hostile/russian/ranged,/turf/simulated/floor/wood{tag = "icon-wood-broken2"; icon_state = "wood-broken2"},/area/dungeon)
"aG" = (/turf/simulated/floor/wood{tag = "icon-wood-broken7"; icon_state = "wood-broken7"},/area/dungeon)
"aH" = (/obj/machinery/door/airlock/wood,/turf/simulated/floor/wood,/area/dungeon)
"aI" = (/mob/living/simple_animal/hostile/russian,/turf/simulated/floor/wood{tag = "icon-wood-broken3"; icon_state = "wood-broken3"},/area/dungeon)
"aJ" = (/obj/structure/table/holo/wood,/obj/machinery/light,/turf/simulated/floor/wood{tag = "icon-wood-broken3"; icon_state = "wood-broken3"},/area/dungeon)
"aK" = (/turf/simulated/floor/wood{tag = "icon-wood-broken3"; icon_state = "wood-broken3"},/area/dungeon)
"aL" = (/obj/machinery/light,/turf/simulated/floor/wood,/area/dungeon)
"aM" = (/mob/living/simple_animal/hostile/russian,/turf/simulated/floor/wood,/area/dungeon)
"aN" = (/turf/simulated/floor/plating/snow,/turf/simulated/floor/plating/snow{tag = "icon-gravsnow_corner (NORTH)"; icon_state = "gravsnow_corner"; dir = 1},/area/dungeon)
"aO" = (/turf/simulated/floor/plating/snow,/turf/simulated/floor/plating/snow{tag = "icon-gravsnow_corner (SOUTHEAST)"; icon_state = "gravsnow_corner"; dir = 6},/area/dungeon)
"aP" = (/turf/simulated/floor/plating/snow/gravsnow,/obj/machinery/light{tag = "icon-glowshroom3"; icon_state = "glowshroom3"; step_x = 18; step_y = 4},/turf/simulated/floor/plating/snow{tag = "icon-snow_corner (EAST)"; icon_state = "snow_corner"; dir = 4},/area/dungeon)
"aQ" = (/turf/simulated/floor/plating/snow,/obj/structure/reagent_dispensers/keg/aphro{step_x = -16},/turf/simulated/wall/mineral/wood{tag = "icon-2-e"; icon_state = "2-e"},/area/dungeon)
"aR" = (/turf/simulated/floor/plating/snow,/turf/simulated/wall/mineral/wood{tag = "icon-2-i"; icon_state = "2-i"},/turf/simulated/wall/mineral/wood{tag = "icon-4-s"; icon_state = "4-s"},/turf/simulated/wall/mineral/wood{tag = "icon-1-w"; icon_state = "1-w"},/area/dungeon)
"aS" = (/turf/simulated/floor/plating/snow,/turf/simulated/wall/mineral/wood{tag = "icon-1-i"; icon_state = "1-i"},/turf/simulated/wall/mineral/wood{tag = "icon-2-e"; icon_state = "2-e"},/turf/simulated/wall/mineral/wood{tag = "icon-3-s"; icon_state = "3-s"},/area/dungeon)
"aT" = (/turf/simulated/floor/plating/snow,/turf/simulated/floor/plating/snow{tag = "icon-gravsnow_corner"; icon_state = "gravsnow_corner"},/turf/simulated/floor/plating/snow{tag = "icon-snow_corner (EAST)"; icon_state = "snow_corner"; dir = 4},/area/dungeon)
"aU" = (/turf/simulated/floor/plating/snow/gravsnow,/turf/simulated/floor/plating/snow{tag = "icon-snow_corner"; icon_state = "snow_corner"},/area/dungeon)
"aV" = (/turf/simulated/floor/plasteel/stairs/left,/area/dungeon)
"aW" = (/turf/simulated/floor/plasteel/stairs/right,/area/dungeon)
"aX" = (/turf/simulated/floor/plating/snow/gravsnow,/turf/simulated/floor/plating/snow{tag = "icon-snow_surround (EAST)"; icon_state = "snow_surround"; dir = 4},/area/dungeon)
"aY" = (/turf/simulated/floor/plating/snow,/turf/simulated/wall/mineral/wood{tag = "icon-2-n"; icon_state = "2-n"},/area/dungeon)
"aZ" = (/turf/simulated/floor/plating/snow,/turf/simulated/wall/mineral/wood{tag = "icon-1-n"; icon_state = "1-n"},/area/dungeon)
"ba" = (/obj/structure/flora/grass/brown,/turf/simulated/floor/plating/snow,/area/dungeon)
"bb" = (/turf/simulated/floor/plating/snow,/turf/simulated/floor/plating/snow{tag = "icon-gravsnow_corner"; icon_state = "gravsnow_corner"},/turf/simulated/floor/plating/snow{tag = "icon-gravsnow_surround (EAST)"; icon_state = "gravsnow_surround"; dir = 4},/area/dungeon)
"bc" = (/turf/simulated/floor/plating/snow,/obj/structure/flora/grass/green,/turf/simulated/floor/plating/snow{tag = "icon-snow_corner"; icon_state = "snow_corner"},/area/dungeon)
"bd" = (/obj/structure/flora/rock,/turf/simulated/floor/plating/snow/gravsnow,/area/dungeon)
"be" = (/turf/simulated/floor/plating/snow/gravsnow,/turf/simulated/floor/plating/snow{tag = "icon-snow_surround (NORTH)"; icon_state = "snow_surround"; dir = 1},/area/dungeon)
"bf" = (/turf/simulated/floor/plasteel/stairs/old,/area/dungeon)
"bg" = (/turf/simulated/floor/plating/snow/gravsnow,/turf/simulated/floor/plating/snow{tag = "icon-gravsnow_corner"; icon_state = "gravsnow_corner"},/turf/simulated/floor/plating/snow{tag = "icon-gravsnow_corner (NORTH)"; icon_state = "gravsnow_corner"; dir = 1},/turf/simulated/floor/plating/snow{tag = "icon-snow_corner (EAST)"; icon_state = "snow_corner"; dir = 4},/area/dungeon)
"bh" = (/turf/simulated/wall/mineral/wood,/turf/simulated/floor/plating/snow{tag = "icon-snow_corner (WEST)"; icon_state = "snow_corner"; dir = 8},/turf/simulated/floor/plating/snow{tag = "icon-snow_corner (NORTH)"; icon_state = "snow_corner"; dir = 1},/area/dungeon)
"bi" = (/obj/machinery/vending/sustenance{step_y = -7},/turf/simulated/wall/mineral/wood,/area/dungeon)
"bj" = (/turf/simulated/wall/mineral/wood,/turf/simulated/floor/plating/snow{tag = "icon-gravsnow_corner (NORTHEAST)"; icon_state = "gravsnow_corner"; dir = 5},/area/dungeon)
"bk" = (/turf/simulated/wall/mineral/wood,/turf/simulated/floor/plating/snow{tag = "icon-snow_corner (NORTHEAST)"; icon_state = "snow_corner"; dir = 5},/area/dungeon)
"bl" = (/turf/simulated/floor/plating/snow,/obj/structure/flora/rock/pile,/turf/simulated/floor/plating/snow{tag = "icon-gravsnow_corner (EAST)"; icon_state = "gravsnow_corner"; dir = 4},/area/dungeon)
"bm" = (/obj/structure/closet/gimmick/tacticool,/turf/simulated/floor/wood,/area/dungeon)
"bn" = (/turf/simulated/floor/plating/snow/gravsnow,/turf/simulated/floor/plating/snow{tag = "icon-snow_surround"; icon_state = "snow_surround"},/area/dungeon)
"bo" = (/obj/structure/dresser{step_x = -3; step_y = 3},/obj/machinery/light{dir = 1},/turf/simulated/floor/wood,/area/dungeon)
"bp" = (/obj/structure/bed/chair/wood/normal{tag = "icon-wooden_chair (EAST)"; icon_state = "wooden_chair"; dir = 4},/turf/simulated/floor/wood,/area/dungeon)
"bq" = (/turf/simulated/floor/plating/snow/gravsnow,/turf/simulated/floor/plating/snow{tag = "icon-snow_corner (EAST)"; icon_state = "snow_corner"; dir = 4},/turf/simulated/floor/plating/snow{tag = "icon-gravsnow_corner (EAST)"; icon_state = "gravsnow_corner"; dir = 4},/area/dungeon)
"br" = (/turf/simulated/floor/plating/snow,/turf/simulated/floor/plating/snow{tag = "icon-gravsnow_corner (WEST)"; icon_state = "gravsnow_corner"; dir = 8},/area/dungeon)
"bs" = (/turf/simulated/floor/plating/snow/gravsnow,/mob/living/simple_animal/hostile/tree,/turf/simulated/floor/plating/snow{tag = "icon-snow_corner"; icon_state = "snow_corner"},/area/dungeon)
"bt" = (/obj/structure/closet/gimmick/russian,/turf/simulated/floor/wood,/area/dungeon)
"bu" = (/mob/living/simple_animal/hostile/tree,/turf/simulated/floor/plating/snow/gravsnow,/area/dungeon)
"bv" = (/turf/simulated/floor/wood{tag = "icon-wood-broken"; icon_state = "wood-broken"},/area/dungeon)
"bw" = (/obj/structure/closet/gimmick/russian,/obj/machinery/light,/turf/simulated/floor/wood,/area/dungeon)
"bx" = (/turf/simulated/floor/plating/snow,/obj/structure/flora/grass/green,/turf/simulated/floor/plating/snow{tag = "icon-gravsnow_corner (NORTH)"; icon_state = "gravsnow_corner"; dir = 1},/area/dungeon)
"by" = (/turf/simulated/floor/plating/snow,/mob/living/simple_animal/hostile/tree,/turf/simulated/floor/plating/snow{tag = "icon-gravsnow_corner (NORTH)"; icon_state = "gravsnow_corner"; dir = 1},/area/dungeon)
"bz" = (/turf/simulated/floor/plating/snow,/obj/structure/flora/rock/pile,/turf/simulated/floor/plating/snow{tag = "icon-gravsnow_corner (NORTH)"; icon_state = "gravsnow_corner"; dir = 1},/area/dungeon)
"bA" = (/turf/simulated/floor/plating/snow/gravsnow,/turf/simulated/floor/plating/snow{tag = "icon-gravsnow_corner"; icon_state = "gravsnow_corner"},/area/dungeon)
"bB" = (/turf/simulated/floor/plating/snow,/turf/simulated/floor/plating/snow{tag = "icon-gravsnow_corner"; icon_state = "gravsnow_corner"},/turf/simulated/floor/plating/snow{tag = "icon-gravsnow_corner (NORTH)"; icon_state = "gravsnow_corner"; dir = 1},/area/dungeon)
"bC" = (/turf/simulated/floor/plating/snow,/turf/simulated/floor/plating/snow{tag = "icon-snow_corner (NORTH)"; icon_state = "snow_corner"; dir = 1},/area/dungeon)
"bD" = (/turf/simulated/wall/mineral/wood,/turf/simulated/floor/plating/snow{tag = "icon-snow_corner"; icon_state = "snow_corner"},/turf/simulated/floor/plating/snow{tag = "icon-snow_corner (WEST)"; icon_state = "snow_corner"; dir = 8},/area/dungeon)
"bE" = (/turf/simulated/wall/mineral/wood,/turf/simulated/floor/plating/snow{tag = "icon-snow_corner"; icon_state = "snow_corner"},/area/dungeon)
"bF" = (/turf/simulated/wall/mineral/wood,/turf/simulated/floor/plating/snow{tag = "icon-snow_corner"; icon_state = "snow_corner"},/turf/simulated/floor/plating/snow{tag = "icon-snow_corner (SOUTHEAST)"; icon_state = "snow_corner"; dir = 6},/area/dungeon)
"bG" = (/obj/machinery/light,/mob/living/simple_animal/hostile/russian,/turf/simulated/floor/wood,/area/dungeon)
"bH" = (/turf/simulated/floor/plating/snow,/mob/living/simple_animal/hostile/tree,/turf/simulated/floor/plating/snow{tag = "icon-gravsnow_corner"; icon_state = "gravsnow_corner"},/area/dungeon)
"bI" = (/turf/simulated/floor/plating/snow,/turf/simulated/floor/plating/snow{tag = "icon-snow_corner"; icon_state = "snow_corner"},/area/dungeon)
"bJ" = (/turf/simulated/floor/plasteel/showroomfloor,/turf/simulated/floor/plating/snow{tag = "icon-gravsnow_corner (WEST)"; icon_state = "gravsnow_corner"; dir = 8},/turf/simulated/floor/plating/snow{tag = "icon-snow_corner (WEST)"; icon_state = "snow_corner"; dir = 8},/turf/simulated/floor/plating/snow{tag = "icon-snow_corner"; icon_state = "snow_corner"},/area/dungeon)
"bK" = (/turf/simulated/floor/plasteel/showroomfloor,/turf/simulated/floor/plating/snow{tag = "icon-snow_corner (EAST)"; icon_state = "snow_corner"; dir = 4},/turf/simulated/floor/plating/snow{tag = "icon-gravsnow_corner"; icon_state = "gravsnow_corner"},/area/dungeon)
"bL" = (/turf/simulated/floor/plating/snow,/turf/simulated/floor/plating/snow{tag = "icon-snow_corner (EAST)"; icon_state = "snow_corner"; dir = 4},/area/dungeon)
"bM" = (/turf/simulated/wall/mineral/wood,/turf/simulated/floor/plating/snow{tag = "icon-snow_corner (SOUTHEAST)"; icon_state = "snow_corner"; dir = 6},/area/dungeon)
"bN" = (/turf/simulated/floor/plasteel/cult,/obj/structure/window{tag = "icon-window (SOUTHEAST)"; icon_state = "window"; dir = 6},/turf/simulated/floor/plating/snow{tag = "icon-gravsnow_corner (NORTH)"; icon_state = "gravsnow_corner"; dir = 1},/area/dungeon)
"bO" = (/turf/simulated/floor/plating/snow/gravsnow,/turf/simulated/floor/plating/snow{tag = "icon-snow_corner (NORTH)"; icon_state = "snow_corner"; dir = 1},/turf/simulated/floor/plating/snow{tag = "icon-snow_corner (WEST)"; icon_state = "snow_corner"; dir = 8},/area/dungeon)
"bP" = (/turf/simulated/floor/plating/snow/gravsnow,/turf/simulated/floor/plating/snow{tag = "icon-gravsnow_corner (EAST)"; icon_state = "gravsnow_corner"; dir = 4},/area/dungeon)
"bQ" = (/turf/simulated/floor/plating/snow,/turf/simulated/floor/plating/snow{tag = "icon-snow_corner (EAST)"; icon_state = "snow_corner"; dir = 4},/turf/simulated/floor/plating/snow{tag = "icon-gravsnow_corner (NORTHWEST)"; icon_state = "gravsnow_corner"; dir = 9},/area/dungeon)
"bR" = (/obj/structure/filingcabinet{step_x = -6},/obj/structure/filingcabinet{step_x = 3},/obj/machinery/light{dir = 1},/turf/simulated/floor/wood,/area/dungeon)
"bS" = (/obj/machinery/light{dir = 1},/mob/living/simple_animal/hostile/russian,/turf/simulated/floor/wood,/area/dungeon)
"bT" = (/obj/structure/flora/grass/both,/turf/simulated/floor/plating/snow/gravsnow,/area/dungeon)
"bU" = (/obj/structure/mirror{step_y = -9},/turf/simulated/wall/mineral/wood,/area/dungeon)
"bV" = (/obj/structure/extinguisher_cabinet{step_y = -7},/turf/simulated/wall/mineral/wood,/area/dungeon)
"bW" = (/turf/simulated/floor/carpet,/turf/simulated/floor/carpet{tag = "icon-1-i"; icon_state = "1-i"},/turf/simulated/floor/carpet{tag = "icon-3-s"; icon_state = "3-s"},/turf/simulated/floor/carpet{tag = "icon-2-e"; icon_state = "2-e"},/turf/simulated/floor/carpet{tag = "icon-1-n"; icon_state = "1-n"},/turf/simulated/floor/carpet{tag = "icon-4-se"; icon_state = "4-se"},/turf/simulated/floor/carpet{tag = "icon-1-i"; icon_state = "1-i"},/area/dungeon)
"bX" = (/turf/simulated/floor/carpet,/turf/simulated/floor/carpet{tag = "icon-2-n"; icon_state = "2-n"},/turf/simulated/floor/carpet{tag = "icon-2-i"; icon_state = "2-i"},/turf/simulated/floor/carpet{tag = "icon-2-e"; icon_state = "2-e"},/turf/simulated/floor/carpet{tag = "icon-1-w"; icon_state = "1-w"},/turf/simulated/floor/carpet{tag = "icon-4-s"; icon_state = "4-s"},/turf/simulated/floor/carpet{tag = "icon-3-sw"; icon_state = "3-sw"},/turf/simulated/floor/carpet{tag = "icon-2-i"; icon_state = "2-i"},/area/dungeon)
"bY" = (/turf/simulated/floor/plasteel/showroomfloor,/turf/simulated/floor/plating/snow{tag = "icon-gravsnow_corner (WEST)"; icon_state = "gravsnow_corner"; dir = 8},/turf/simulated/floor/plating/snow{tag = "icon-gravsnow_corner (EAST)"; icon_state = "gravsnow_corner"; dir = 4},/turf/simulated/floor/plating/snow{tag = "icon-gravsnow_surround (NORTH)"; icon_state = "gravsnow_surround"; dir = 1},/area/dungeon)
"bZ" = (/turf/simulated/floor/plating/snow,/turf/simulated/floor/plating/snow{tag = "icon-gravsnow_corner (WEST)"; icon_state = "gravsnow_corner"; dir = 8},/mob/living/simple_animal/hostile/tree,/turf/simulated/floor/plating/snow{tag = "icon-gravsnow_surround"; icon_state = "gravsnow_surround"},/area/dungeon)
"ca" = (/obj/machinery/food_cart,/turf/simulated/floor/wood,/area/dungeon)
"cb" = (/turf/simulated/floor/carpet,/turf/simulated/floor/carpet{tag = "icon-3-w"; icon_state = "3-w"},/turf/simulated/floor/carpet{tag = "icon-4-e"; icon_state = "4-e"},/turf/simulated/floor/carpet{tag = "icon-3-s"; icon_state = "3-s"},/turf/simulated/floor/carpet{tag = "icon-3-i"; icon_state = "3-i"},/turf/simulated/floor/carpet{tag = "icon-1-n"; icon_state = "1-n"},/turf/simulated/floor/carpet{tag = "icon-3-i"; icon_state = "3-i"},/obj/structure/bed/chair/office/light,/turf/simulated/floor/carpet{tag = "icon-2-ne"; icon_state = "2-ne"},/area/dungeon)
"cc" = (/turf/simulated/floor/carpet,/turf/simulated/floor/carpet{tag = "icon-3-w"; icon_state = "3-w"},/turf/simulated/floor/carpet{tag = "icon-4-e"; icon_state = "4-e"},/turf/simulated/floor/carpet{tag = "icon-2-n"; icon_state = "2-n"},/turf/simulated/floor/carpet{tag = "icon-4-i"; icon_state = "4-i"},/turf/simulated/floor/carpet{tag = "icon-1-nw"; icon_state = "1-nw"},/area/dungeon)
"cd" = (/turf/simulated/floor/plasteel/showroomfloor,/turf/simulated/floor/plating/snow{tag = "icon-gravsnow_corner (WEST)"; icon_state = "gravsnow_corner"; dir = 8},/turf/simulated/floor/plating/snow{tag = "icon-gravsnow_corner (SOUTHWEST)"; icon_state = "gravsnow_corner"; dir = 10},/turf/simulated/floor/plating/snow{tag = "icon-snow_corner (EAST)"; icon_state = "snow_corner"; dir = 4},/area/dungeon)
"ce" = (/turf/simulated/floor/plating/snow,/turf/simulated/floor/plating/snow{tag = "icon-gravsnow_surround (NORTH)"; icon_state = "gravsnow_surround"; dir = 1},/turf/simulated/floor/plating/snow{tag = "icon-snow_corner (WEST)"; icon_state = "snow_corner"; dir = 8},/turf/simulated/floor/plating/snow{tag = "icon-gravsnow_corner"; icon_state = "gravsnow_corner"},/area/dungeon)
"cf" = (/obj/structure/flora/grass/brown,/turf/simulated/floor/plating/snow/gravsnow,/area/dungeon)
"cg" = (/turf/simulated/floor/plating/snow/gravsnow,/turf/simulated/floor/plating/snow{tag = "icon-gravsnow_corner"; icon_state = "gravsnow_corner"},/turf/simulated/floor/plating/snow{tag = "icon-snow_corner (EAST)"; icon_state = "snow_corner"; dir = 4},/area/dungeon)
"ch" = (/obj/structure/table/holo/wood,/obj/structure/rack{step_x = 1; step_y = 10},/obj/machinery/light,/turf/simulated/floor/wood{tag = "icon-wood-broken"; icon_state = "wood-broken"},/area/dungeon)
"ci" = (/obj/machinery/light,/turf/simulated/floor/wood{tag = "icon-wood-broken2"; icon_state = "wood-broken2"},/area/dungeon)
"cj" = (/turf/simulated/floor/plating/snow,/turf/simulated/floor/plating/snow{tag = "icon-gravsnow_corner (NORTHEAST)"; icon_state = "gravsnow_corner"; dir = 5},/area/dungeon)
"ck" = (/turf/simulated/floor/plating/snow/gravsnow,/turf/simulated/floor/plating/snow{tag = "icon-snow_corner (WEST)"; icon_state = "snow_corner"; dir = 8},/turf/simulated/floor/plating/snow{tag = "icon-gravsnow_corner (WEST)"; icon_state = "gravsnow_corner"; dir = 8},/area/dungeon)
"cl" = (/obj/structure/flora/rock/pile,/turf/simulated/floor/plating/snow/gravsnow,/area/dungeon)
"cm" = (/turf/simulated/floor/plasteel/showroomfloor,/turf/simulated/floor/plating/snow{tag = "icon-gravsnow_corner (WEST)"; icon_state = "gravsnow_corner"; dir = 8},/area/dungeon)
"cn" = (/obj/structure/table/holo/wood,/obj/structure/reagent_dispensers/beerkeg{step_x = 4; step_y = 4},/turf/simulated/floor/wood,/area/dungeon)
"co" = (/turf/simulated/floor/plating/snow,/turf/simulated/floor/plating/snow{tag = "icon-gravsnow_corner (NORTHWEST)"; icon_state = "gravsnow_corner"; dir = 9},/area/dungeon)
"cp" = (/obj/structure/extinguisher_cabinet{step_y = 5},/turf/simulated/wall/mineral/wood,/area/dungeon)
"cq" = (/turf/simulated/floor/plating/snow,/obj/structure/flora/bush,/turf/simulated/floor/plating/snow{tag = "icon-gravsnow_corner (EAST)"; icon_state = "gravsnow_corner"; dir = 4},/area/dungeon)
"cr" = (/turf/simulated/floor/plasteel/showroomfloor,/turf/simulated/floor/plating/snow{tag = "icon-gravsnow_surround (NORTH)"; icon_state = "gravsnow_surround"; dir = 1},/area/dungeon)
"cs" = (/obj/structure/bed/chair/wood/normal{tag = "icon-wooden_chair (WEST)"; icon_state = "wooden_chair"; dir = 8},/mob/living/simple_animal/hostile/russian/ranged,/turf/simulated/floor/wood,/area/dungeon)
"ct" = (/obj/machinery/vending/dinnerware{step_x = -8},/turf/simulated/wall/mineral/wood,/area/dungeon)
"cu" = (/obj/structure/closet/crate/trashcart{step_x = -1; step_y = 12},/turf/simulated/floor/plating/snow/gravsnow,/area/dungeon)
"cv" = (/turf/simulated/floor/plasteel/showroomfloor,/turf/simulated/floor/plating/snow{tag = "icon-gravsnow_corner (EAST)"; icon_state = "gravsnow_corner"; dir = 4},/turf/simulated/floor/plating/snow{tag = "icon-gravsnow_corner"; icon_state = "gravsnow_corner"},/turf/simulated/floor/plating/snow{tag = "icon-gravsnow_corner (WEST)"; icon_state = "gravsnow_corner"; dir = 8},/area/dungeon)
"cw" = (/obj/structure/closet/secure_closet/freezer/meat,/turf/simulated/floor/wood,/area/dungeon)
"cx" = (/obj/structure/closet/secure_closet/freezer/fridge,/turf/simulated/floor/wood{tag = "icon-wood-broken3"; icon_state = "wood-broken3"},/area/dungeon)
"cy" = (/obj/structure/sink{tag = "icon-sink (EAST)"; icon_state = "sink"; dir = 4; step_x = 12},/obj/machinery/light,/turf/simulated/floor/wood,/area/dungeon)
"cz" = (/turf/simulated/floor/plasteel/showroomfloor,/turf/simulated/floor/plating/snow{tag = "icon-gravsnow_corner (NORTH)"; icon_state = "gravsnow_corner"; dir = 1},/turf/simulated/floor/plating/snow{tag = "icon-gravsnow_corner (WEST)"; icon_state = "gravsnow_corner"; dir = 8},/turf/simulated/floor/plating/snow{tag = "icon-snow_corner (EAST)"; icon_state = "snow_corner"; dir = 4},/area/dungeon)
"cA" = (/obj/structure/flora/rock/pile,/turf/simulated/floor/plating/snow,/area/dungeon)
"cB" = (/turf/simulated/floor/plating/snow,/obj/structure/flora/tree/dead,/turf/simulated/floor/plating/snow{tag = "icon-gravsnow_corner (EAST)"; icon_state = "gravsnow_corner"; dir = 4},/area/dungeon)
"cC" = (/turf/simulated/floor/plating/snow/gravsnow,/turf/simulated/floor/plating/snow{tag = "icon-snow_corner (NORTH)"; icon_state = "snow_corner"; dir = 1},/mob/living/simple_animal/hostile/tree,/turf/simulated/floor/plating/snow{tag = "icon-snow_corner"; icon_state = "snow_corner"},/area/dungeon)
"cD" = (/turf/simulated/floor/plasteel/showroomfloor,/turf/simulated/floor/plating/snow{tag = "icon-gravsnow_corner (EAST)"; icon_state = "gravsnow_corner"; dir = 4},/turf/simulated/floor/plating/snow{tag = "icon-gravsnow_corner (WEST)"; icon_state = "gravsnow_corner"; dir = 8},/turf/simulated/floor/plating/snow{tag = "icon-gravsnow_corner"; icon_state = "gravsnow_corner"},/area/dungeon)
"cE" = (/turf/simulated/floor/plating/snow/gravsnow,/turf/simulated/floor/plating/snow{tag = "icon-snow_corner (WEST)"; icon_state = "snow_corner"; dir = 8},/turf/simulated/floor/plating/snow{tag = "icon-snow_corner"; icon_state = "snow_corner"},/turf/simulated/floor/plating/snow{tag = "icon-snow_corner (SOUTHWEST)"; icon_state = "snow_corner"; dir = 10},/area/dungeon)
"cF" = (/turf/simulated/floor/plating/snow/gravsnow,/turf/simulated/floor/plating/snow{tag = "icon-snow_corner"; icon_state = "snow_corner"},/turf/simulated/floor/plating/snow{tag = "icon-snow_corner (EAST)"; icon_state = "snow_corner"; dir = 4},/area/dungeon)
"cG" = (/obj/structure/signpost,/turf/simulated/floor/plating/snow,/area/dungeon)

(1,1,1) = {"
aaaaaaaaaaaaaaaaaaaaaaaaaaaaaaaaaaaaaaaaaaaaaaaaab
aaaaacacadaaaaadaaaeaaaaaaaaadafafafagaaahacaaaaaa
aaaiajakaaaaalamamalalalanaoapaqaqaqarasaiataaanaa
aaauavaaaaaaamawaxaxayalalalazaAaBaCaqaDahavaEaaaa
aaaaaeaaanacamaxaFaBaGaBaBaHaBaBaIaBaqaDaaaaavadaa
aaajaaaaahajalaJaBaKaLalalalaBaMaBaBaqaDaaanaNaaaa
aaanaaaaaOajalalaBaBalalaPaQaRaLaGaLaSaaaaaaaTaaag
aaaaaaaiajajaUalaVaWalajajaXaYalaHalaZaaanahavaaaa
aabaaaacbbavbcalaBaBalbdavadbealbfalaaaaadacbgaaaa
aaaaaaajajavbhbiaVaWalbjavaaalalaBalalbkahajakaaaa
aeaaanblajajalaGaBaBbmalbnaaalboaBbpayalahajbqbraa
aaadacahbsajamaBaCaIbtalaabualbvaBbpaxamahaaavaaaa
aaahavaaahaUamaLaBaBbwalaabxalaBaBbpaxamaabybzaaaa
aabAbBacadbCbDbEaHaHbEbFaaaaalbGaBaBaLalaeaaaabHaa
ahbuajavaaaabIaabJbKbLaaaaacalalaBaKalbMaaaaaOavaa
aaalalbNamalalbHbOajbradbuajajalaVaWalaaaabPbqbQaa
agalbRaBaBbSaHajajbTbralbUalbValaBaBalaaaaanaNaaaa
aaalaBbWbXaBalajbYajbZalaBcaaxayaBaCalacbHaaaaaaaa
aaalaxcbccaBamajcdceajalaKaBaBaBaBaLalcfcgaaadaaaa
aaalchaxaBciamcjckclcmaHaBaxaxcnbvalalajcoaeaaanaa
aaalbEalcpalbEcqajcrajalaBaxcsaBaBctcuajaaaaaaaaaa
aaaaaaaaaaaaaaahajcvcoamaLaxcwcxcyalajcoanaaaaaaaa
aaabadaaaabaaaaaajczaaalbEalamamalalaNaaaacAanaaaa
anaaaaanaaaacBcCajcDaaaaahajcfavaaaaaaanaaaaaaaaaa
aaaaaaaaanaaaaaacEcFcGaaaaaNaNaNaaadanaaaaanaaaaaa
"}
